F 76,76,76
C 135, 206, 235

NO textures/simonkraft/cobblestone.xpm
SO textures/simonkraft/basalt_top.xpm
WE textures/simonkraft/mossy_cobblestone1.xpm
EA textures/simonkraft/soul_sand.xpm 



1111111111111111111
10W1001001001000001
10001000001000001001
1001001001111101111
1001111000001001001
1000000000000001001
1001111111111001001
1111000000000001011
1000000001000000001
1111111111111111111

